####################
#S#...............##
#.#.#####.#######.#.
#.#.#...#.#.....#.#.
#.#.#.#.#.#.###.#.#.
#...#.#.#.#...#.#.#.
###.#.#.#.###.#.#.#.
#...#.#.#.....#.#.#.
#.#.#.#.#######.#.#.
#.#.#.#.........#.#.
#.#.#.###########.#.
#.#...............G#
####################
