####################
#S....#...........##
#.##.#.#.#######.#.#
#.#..#.#.#.....#.#.#
#.#.##.#.#.###.#.#.#
#.#....#.#.#.#.#.#.#
#.######.#.#.#.#.#.#
#........#.#.#.#.#.#
##########.#.#.#.#.#
#..........#.#.#.#.#
#.##########.#.#.#G#
#............#.#...#
####################
