######################
#S.....#............##
#.###.#.######.#######
#.#.#.#.#....#.......#
#.#.#.#.#.####.#####.#
#.#.#...#......#...#.#
#.###.##########.#.#.#
#.....#........#.#.#.#
#####.#.######.#.#.#.#
#...#.#....#....#.#..#
#.#.#.####.#.####.#G##
#.#.#......#......#..#
#.##################.#
#....................#
######################
